1111111111
1        1
1        1
1 344   31
1        1
1    222 1
1        1
123232   1
1        1
1111111111