1111111111
1        1
1        1
1 122   11
1        1
1    222 1
1        1
121212   1
1        1
1111111111