1111111111
1        1
1        1
1 3333   1
1        1
1     3  1
1        1
123232   1
1        1
1111111111