2222222222
2        2
2222222  2
2        2
2  2222222
2        2
2222222  2
2        2
2        2
2222222222